på=on
så=so
være=be
må=must
gør=do
få=few
gøre=do
gå=go
går=walks
når=when
måske=maybe
også=also
får=sheep
sådan=such
væk=away
åh=oh
været=been
før=before
år=year
hør=hear
død=death
nå=reach
første=first
hjælpe=help
vær=be
hjælp=help
forstår=understand
høre=hear
fortælle=tell
står=stands
nødt=need
længe=for a long time
døde=died
måde=manner
selvfølgelig=of course
fået=got
først=first
næste=next
øjeblik=moment
mænd=men
behøver=needs
søn=son
prøver=samples
dø=die
børn=children
slå=beat
møde=meet
ønsker=wishes
altså=that is
hørt=heard
hører=belongs
dræbe=kill
hvornår=when
fortæl=tell
dør=door
hørte=heard
håber=hope
længere=further
sæt=set
kører=driving
næsten=almost
kæft=shut up
gået=gone
spørgsmål=questions
prøve=sample
tænkte=thought
sød=sweet
løb=race
tænker=think
færdig=done
våben=arms
køre=drive
slår=hits
hånd=hand
stå=stand
tænk=think
døren=the door
tænke=think
svært=difficult
føler=feel
prøv=try
fortæller=narrator
tæt=close
dræbt=killed
øjne=eyes
lære=learn
dræbte=killed
søster=sister
små=small
forstået=understood
måtte=mat
præcis=exactly
bør=ought to
røven=the ass
øje=eye
læg=lay
spørge=ask
værsgo=here you go
kære=dear
kæreste=girlfriend
knægt=boy
tænkt=thought
kærlighed=love
måneder=months
forstå=understand
sætte=put
røv=ass
prøvede=tried
foregår=going
ønske=wish
hårdt=hard
sætter=puts
dræber=kills
højre=right
værelse=room
hjælper=helps
kør=drive
træk=drag
hænder=hands
kæmpe=competing
værd=worth
forældre=parents
tøj=clothing
værre=worse
dårligt=bad
træt=tired
spørger=asks
købe=buy
følge=follow
største=largest
mærke=feel
desværre=unfortunately
søde=sweetie
nød=nut
øjnene=the eyes
dårlig=bad
mødes=meet
skød=lap
læse=read
følger=follows
hår=hair
større=bigger
præsident=president
løbe=run
øh=uh
fortsæt=continue
åbne=open
højt=high
slået=beaten
følg=follow
røvhul=asshole
ære=honour
fængsel=prison
døden=death
rør=tube
hænderne=the hands
drøm=dream
åben=open
tør=dry
råd=advice
født=born
føles=feels
løber=runs
mødt=met
fører=driver
lærer=teacher
slås=fight
læge=doctor
ændre=amend
ægte=genuine
ødelægge=destroy
prøvet=tried
børnene=the children
skør=crazy
mødte=met
ærligt=honestly
kørte=driving
føle=feel
forsøger=trying
blå=blue
pænt=nice
stærk=strong
nær=near
frøken=miss
løgn=lie
lært=learned
løs=loose
dræb=kill
øl=beer
løjtnant=lieutenant
lægge=put
trække=drag
færdige=done
hær=army
læst=read
mål=goal
kræver=demands
skønt=wonderful
både=boats
værste=worst
lærte=taught
spørg=ask
ønskede=wished
sværger=swear
sjæl=soul
høj=high
skæbne=fate
præsidenten=the president
brød=bread
følelser=emotions
særlig=particular
fortsætte=continue
ødelagt=destroyed
håb=hope
løbet=run
trækker=pulls
hånden=the hand
søger=searching
området=the area
drømme=dream
måned=month
røre=touch
skål=cheers
fornøjelse=pleasure
forsøgte=tried
vågn=awake
udmærket=fine
lægger=puts
hård=hard
møder=meetings
røde=red
ærlig=honest
såret=hurt
sælge=sell
sødt=sweet
nervøs=nervous
tænder=teeth
føre=lead
bære=bear
lå=lay
nødvendigt=necessary
køber=buyer
søvn=sleep
område=territory
tilfælde=coincidence
vælge=choose
læser=reader
båd=boat
sælger=selling
glæde=joy
stjålet=stolen
fuldstændig=complete
besøg=visit
stjæle=steal
åbner=opens
brænder=burns
kæmper=fighting
højere=higher
fortsætter=continues
nærheden=the vicinity
forsøg=attempt
lækker=delicious
overstået=over
købte=bought
dårlige=bad
ovenpå=on top
kælling=bitch
kræfter=strength
kød=meat
røg=smoke
træ=tree
nøglen=the key
mørke=darkness
især=especially
års=years
åbenbart=apparently
målet=the goal
hænger=hangs
dæk=tire
seriøst=seriously
tilhører=belongs to
åbn=open
fødselsdag=birthday
sørg=grieve
øen=the island
løj=lied
ændret=changed
ældre=older
undgå=avoid
rører=stirring
bærer=carries
rød=red
glæder=rejoices
spændende=exciting
ødelægger=destroying
sværd=sword
kørt=driven
låne=borrow
særligt=especially
nærmere=closer
købt=bought
vælger=choose
følte=felt
mærkeligt=strange
låst=locked
bøger=books
brødre=brothers
træner=coach
fængslet=the prison
båden=the boat
nærmer=approaching
trænger=need
høje=tall
gælder=applies
læste=read
sørge=mourn
hævn=revenge
majestæt=majesty
hæren=the army
mødtes=met
bånd=tape
bevæger=moves
besøge=visit
ifølge=according to
række=row
nåde=mercy
lægen=the doctor
fødder=feet
træd=tread
tøs=lass
opmærksomhed=attention
æg=egg
læs=read
fortræd=mischief
løfte=lift
præsentere=present
nåede=made it
brænde=burn
tæller=counting
fætter=cousin
forsøge=try
nået=reached
støtte=support
fælde=trap
ændrer=change
lækkert=delicious
ægteskab=marriage
ødelagde=destroyed
glædelig=joyful
gøres=done
løse=solve
undersøge=look into
næppe=barely
forfærdeligt=terrible
knæ=knee
stærke=strong
håbede=hoped
skøre=crazy
tættere=closer
dække=cover
gæster=guests
gæt=guess
nægter=denies
mistænkte=suspect
lørdag=saturday
spørgsmålet=the question
vågen=awake
angående=regarding
hænge=hang
stærkt=strongly
bøsse=gay
skære=cut
mød=meet
grænsen=the border
mørket=the darkness
mændene=the men
næ=nah
køkkenet=the kitchen
vågner=wakes up
størrelse=size
stærkere=stronger
græde=cry
årevis=for years
foretrækker=prefer
vædde=bet
opfører=behaves
væggen=the wall
fløj=flew
sørger=mourns
næse=nose
øre=ear
jøsses=jeez
grønne=green
forsøgt=tried
foreslår=suggests
året=the year
dækker=covers
mørkt=dark
nøglerne=the keys
stjæler=stealing
båndet=the tape
håbe=hope
knægten=the kid
lød=sounded
øst=east
hjørnet=the corner
skræmmer=scares
behøvede=needed
kæmpede=fought
skræmmende=daunting
spøg=joke
højhed=highness
træning=work out
hårde=tough
ånd=spirit
gæst=guest
præcist=spot on
lås=lock
nøgle=key
månen=the moon
dækket=covered
gætte=guess
løgner=liar
næsen=the nose
præst=priest
bekræftet=confirmed
skæbnen=the destiny
halløj=hello
røvhuller=assholes
fælles=common
svømme=swim
søndag=sunday
nævnte=mentioned
gæld=debt
græder=crying
drømmer=dream
nøgen=naked
førte=led
tændt=turned on
løsning=solution
indrømme=admit
køb=purchase
dømt=convicted
pæn=on a
tøjet=the clothes
dæmon=demon
løn=pay
svær=difficult
årig=year old
mødet=the meeting
hjæip=help
strømmen=the power
køn=sex
formål=purpose
stadigvæk=still
hjæipe=cheers
jaså=yes
følelse=feeling
skærer=cutting
skræmme=scare
sårede=wounded
forfærdelig=terrible
kommandør=commander
ønsket=desired
sår=wound
højeste=highest
skørt=skirt
mælk=milk
øjet=the eye
måder=ways
træffe=meet
kærligheden=the love
sært=weird
brændte=burned
brændt=burnt
græd=cried
dækning=coverage
nøgler=keys
døende=dying
inspektør=inspector
skønne=beautiful
værelset=the room
kælderen=the basement
ført=led
skøn=discretion
søen=the lake
begå=commit
betød=meant
tænd=switch on
mærker=brands
udføre=perform
drømte=dreamed
skræmte=scared
højst=highest
skændes=quarrel
bevæge=move
ligeså=likewise
afsløre=reveal
nærmest=closest
åbent=open
begået=committed
vågne=wake
berømt=famous
angår=concerns
legetøj=toy
skønhed=beauty
ører=ears
øjeblikket=the moment
rådet=the advice
stået=stood
humør=mood
berømte=famous
åbnede=opened
opførsel=behavior
retfærdighed=justice
brækket=broken
søstre=sisters
strålende=brilliant
ændrede=changed
håbet=the hope
vrøvl=nonsense
færdigt=done
træne=train
bløder=bleeding
søge=search
flåden=the fleet
århundrede=century
grøn=green
gengæld=in return
kommissær=commissioner
vågnede=woke
sprænge=blow up
trænet=trained
håret=the hair
træer=trees
ræk=row
sænk=lower
væsen=creature
lær=learn
skær=glow
årh=year
røveri=robbery
føreren=the driver
æren=the honor
jakkesæt=suit
spøgelse=ghost
træder=steps
dørene=the doors
strøm=power
sønnike=son
træde=step
træet=the tree
våbnet=the weapon
råbe=shout
afhænger=depends
drømt=dreamed
begår=commits
åbnet=opened
døre=doors
lækre=delicious
sædvanlige=usual
bønner=prayers
gætter=guesses
affære=affair
ørkenen=desert
indså=realized
rødt=red
undersøger=examines
sønner=sons
rørte=touched
hæng=hang
nærmeste=nearest
æde=eat
bevæbnet=armed
brækkede=broke
svære=hard
dæmoner=demons
undersøgt=investigated
klædt=dressed
vælg=choose
klæder=clothes
grønt=green
omstændigheder=circumstances
opføre=perform
løgne=lies
oversættelse=translation
måden=the way
læger=doctors
støtter=supports
nåh=oh
rørt=touched
nævne=mention
løst=solved
vække=wake
opnå=obtain
bevægelse=movement
bekæmpe=combat
røvfuld=full of ass
løft=lift
højde=height
såre=hurt
håndtere=handle
direktør=manager
spændt=tense
rækker=rows
æder=eats
sjæle=souls
nøjagtig=accurate
mistænkt=suspected
kæmpet=fought
hjælpen=the help
årsag=cause
undersøgelse=examination
repræsenterer=represents
militæret=the military
badeværelset=bathroom
usædvanligt=unusual
skåret=cut
åhh=ohh
ulækkert=disgusting
påstår=claims
våbnene=the weapons
narrøv=fool
sådanne=such
forræder=traitor
tøser=bitch
planlægger=plan
chauffør=driver
øverste=top
nødig=hate
nævnt=mentioned
dømme=judge
værk=work
kæmp=fight
sjældent=rarely
besøger=visiting
røret=the tube
tørre=dry
bjørn=bear
tælle=count
værdsætter=appreciate
kræft=cancer
afgøre=decide
råber=yells
føde=food
bemærket=noticed
fødselsdagen=birthday
øve=practice
gevær=gun
bløde=soft
nuværende=present
forhåbentlig=hopefully
blød=soft
sæk=sack
hårdere=harder
våd=wet
tæppe=blanket
følgende=following
søgte=sought
brænd=burn
vægt=weight
ånder=breathes
løfter=promises
snød=cheated
enestående=unique
lån=loan
skræmt=frightened
militær=military
grænser=borders
fødderne=the feet
afsløret=revealed
nordpå=northward
sværere=harder
kærester=girlfriends
gården=the farm
støvler=boots
værdi=value
sværdet=the sword
blæser=fan
jøde=jew
røget=smoked
fræk=naughty
tilbød=offered
rådne=rot
udført=performed
prøven=the sample
ærgerligt=pity
mægtige=grand
tænde=switch on
øvelse=exercise
søg=search
træerne=the trees
kørekort=driver's license
cæsar=caesar
håndjern=handcuffs
ældste=oldest
skærmen=the screen
tålmodighed=patience
besætningen=the crew
besøgte=visited
djævel=devil
løsladt=released
læber=lips
mærkelig=strange
hjørne=corner
sekretær=secretary
nevø=nephew
opfør=behave
møgsvin=dung pig
mærkelige=weird
foreslå=propose
råbte=shouted
omgående=immediately
føltes=felt
forræderi=treason
låse=lock
grå=grey
strømer=currents
sprænger=explodes
forsæt=intention
trætte=tired
hængt=hung
døv=deaf
bøde=lived
stående=standing up
modstå=withstand
således=thus
spøgelser=ghosts
indrømmer=admit
tværs=across
følt=felt
vært=host
brændstof=fuel
spænd=buckle up
øvrigt=by the way
mægtig=mighty
fortæi=fortee
værst=worst
består=consists
måltid=meal
brækker=vomits
forfærdelige=terrible
pæne=pretty
tilfældigvis=coincidentally
vældig=mighty
seriøs=serious
selvføigelig=voluntarily
særlige=special
gennemgå=review
såsom=like
djævlen=the devil
bekræfte=confirm
søns=son's
støv=dust
nøje=carefully
grænse=limit
bøn=prayer
områder=areas
skæg=beard
mørkets=of darkness
vækker=waking
besvær=trouble
tårer=tears
sydpå=to the south
ånde=breathe
spørgsmåi=question mark
æsel=donkey
flåde=fleet
mørk=dark
kredsløb=orbit
græs=grass
dødelig=lethal
forgæves=in vain
jøder=jews
blåt=blue
sø=lake
trænge=need
oprør=rebellion
nøgne=naked
afgørende=essential
rådgiver=adviser
nægtede=refused
afhængig=dependent
tilfældigt=random
gård=farm
bekræfter=confirms
blæse=blow
årige=year olds
nøjagtigt=exactly
måneden=the month
hævet=raised
opmærksom=attentive
rækkevidde=range
soveværelset=bedroom
fløjet=flew
møg=dung
kørende=running
forfølger=stalker
dværg=dwarf
bær=berry
tilstedeværelse=presence
lfølge=following
klæde=cloth
igår=yesterday
tilintetgøre=destroy
nødsituation=emergency
undvære=do without
præsidentens=the president's
djævelen=the devil
trøst=comfort
brødrene=the brothers
behøves=is needed
trøje=shirt
fjæs=face
stål=steel
misforståelse=misunderstanding
røve=rob
sølv=silver
sprøjte=syringe
hævne=avenge
vækkede=woke up
spjældet=the damper
køkken=kitchen
guvernør=governor
tørstig=thirsty
skråt=obliquely
længst=longest
populær=popular
dødt=dead
væsner=creatures
vænne=turn
